

NO ./texture/barrel.xpm
SO ./texture/bluestone.xpm
WE ./texture/colorstone.xpm

F 120,120,120

EA ./textureeagle.xpm

C 245,245,120


        1111111111111111111111111
        1000000000110000000000001
        1011000001110000000000001
        1001000000000000000000001
111111111011000001110000000000001
100000000011000001110111111111111
11110111111111011100000010001
11110111111111011101010010001
11000000110101011100000010001
10000000000000001100000010001
1000000000000W001101010010001         111
110000011101010111110111100011111     101
11110111 1110101 101111010001         111
11111111 1111111 111111111111


