


NO textures/north_texture.xpm

SO textures/south_texture.xpm
WE textures/west_texture.xpm
EA textures/east_texture.xpm

F 93,173,236
C 255,255,230

 111111
10000001
10000001
10E00001
10000001
10000001
 111101
1    1
1
