NO textures/north_texture.xpm

SO textures/south_texture.xpm

WE textures/west_texture.xpm
F 220,100,0

EA textures/east_texture.xpm

C 225,30,0



         11111111111111111111111
        1000000000110000000000001
        1011000001110000000000001
        1001000000000000000000001
 11111111011000001110000000000001
10000000001100000111011111111111
11110111111111011100000000001
11110111111111011101010000001
11000000110101011100000000001
10000000000000001100000010001
10000000000000001101010010001     111
11000001110101011111011110N0111   101
11110111 1110101 101111010001     111
 1111111 1111111 11111111111
